7 7 7 7 7 7 7 7 7 7 7 7 7 7 7 7 7
9 0 0 0 0 0 0 0 0 0 0 0 0 0 0 0 8
9 0 1 2 2 0 1 0 3 0 1 2 2 0 1 0 8
9 0 2 2 4 2 0 3 0 3 2 2 5 2 2 0 8
9 2 2 4 1 4 3 0 0 0 3 5 1 5 2 2 8
9 2 4 4 4 4 4 2 3 2 5 5 5 5 5 2 8
9 2 1 4 1 4 1 2 3 2 1 5 1 5 1 2 8
9 2 2 4 4 4 2 0 3 0 2 5 5 5 2 2 8
9 0 2 2 4 4 4 2 3 2 5 5 5 5 2 0 8
9 0 1 2 2 4 2 0 3 0 2 5 2 2 1 0 8
9 0 0 0 2 2 4 2 3 2 5 2 2 0 0 0 8
9 0 1 0 1 2 2 2 3 2 2 2 1 0 1 0 8
9 0 0 0 0 0 2 2 3 2 2 0 0 0 0 0 8
9 0 1 0 1 0 1 0 0 0 1 0 1 0 1 0 8
6 0 0 0 0 0 0 0 0 0 0 0 0 0 0 0 6
7 0 0 0 0 0 0 0 0 0 0 0 0 0 0 0 7
7 7 7 7 7 7 7 7 7 7 7 7 7 7 7 7 7