7 7 7 7 7 7 7 7 7 7 7 7 7 7 7 7 7
9 0 4 4 4 0 0 0 1 1 0 1 1 0 0 0 8
9 0 0 4 0 0 0 1 4 4 1 4 4 1 0 0 8
9 0 0 4 0 2 2 2 1 4 4 4 1 0 0 0 8
9 2 4 4 4 0 0 0 0 1 4 1 0 0 0 0 8
9 4 0 0 0 5 5 0 4 0 1 0 4 5 5 5 8
9 4 0 0 5 0 0 5 0 4 0 4 0 5 0 0 8
9 4 0 0 5 0 0 5 0 4 0 4 0 5 5 5 8
9 4 0 0 5 0 0 5 0 4 0 4 0 5 0 0 8
9 4 4 4 0 5 5 0 0 0 4 0 0 5 5 5 8
9 0 0 0 0 0 0 0 0 0 0 0 0 0 0 0 8
9 0 0 5 5 5 0 4 4 0 4 4 0 2 2 2 8
9 0 0 5 5 0 5 0 4 4 4 0 2 2 2 0 8
9 0 0 5 5 5 0 0 4 4 0 0 2 2 2 0 8
9 0 0 5 5 0 0 4 4 0 2 2 2 2 0 0 8
9 0 0 5 5 0 4 4 0 0 0 2 2 2 0 0 8
7 7 7 7 7 7 7 7 7 7 7 7 7 7 7 7 7