7 7 7 7 7 7 7 7 7 7 7 7 7 7 7 7 7
9 0 0 0 4 0 4 0 4 2 4 4 2 2 0 0 8
9 0 1 0 0 2 4 4 4 5 5 5 4 4 1 0 8
9 0 0 1 0 2 2 1 1 1 1 1 2 2 1 2 8
9 0 0 0 1 2 2 2 0 5 4 5 2 0 1 0 8
9 2 2 2 2 2 2 0 0 4 5 4 2 0 0 0 8
9 2 1 4 4 1 2 0 1 1 1 1 1 1 1 0 8
9 2 1 1 4 1 2 0 0 0 0 0 4 0 5 0 8
9 2 1 5 1 1 2 5 5 5 5 0 0 1 5 0 8
9 2 1 5 5 1 2 5 1 1 5 5 0 1 0 4 8
9 2 2 2 2 2 2 1 4 4 1 5 0 1 0 4 8
9 1 0 1 1 0 5 4 1 4 4 5 0 1 0 4 8
9 2 0 2 0 0 5 4 4 1 4 5 0 1 0 0 8
9 4 5 1 0 5 5 1 4 4 1 5 0 1 2 0 8
9 5 4 1 4 0 5 5 1 1 5 0 0 0 2 0 8
9 4 2 1 0 0 0 2 0 0 0 2 0 0 0 0 8
7 7 7 7 7 7 7 7 7 7 7 7 7 7 7 7 7