7 7 7 7 7 7 7 7 7 7 7 7 7 7 7 7 7
9 0 0 2 2 4 4 6 5 5 5 5 2 2 2 2 8
9 0 0 2 2 4 4 4 6 5 5 5 2 2 2 2 8
9 2 2 1 1 1 1 1 1 2 1 1 1 1 5 5 8
9 2 2 1 2 2 2 2 2 2 2 2 2 1 5 5 8
9 2 2 1 2 4 1 4 4 1 1 1 2 1 5 5 8
9 2 2 1 2 4 1 1 5 5 5 4 2 1 5 5 8
9 4 4 1 2 4 1 5 5 1 5 1 2 1 5 5 8
9 4 4 1 2 1 5 5 2 5 1 4 2 1 5 5 8
9 4 4 1 2 4 5 1 2 2 5 4 2 1 5 5 8
9 4 4 1 2 4 1 5 1 5 5 1 2 1 5 5 8
9 4 4 1 2 4 4 4 4 4 1 1 2 1 2 2 8
9 4 4 1 2 2 2 2 2 2 2 2 2 1 2 2 8
9 2 2 1 1 1 1 2 1 1 1 1 1 1 2 2 8
9 2 2 2 4 4 4 4 6 5 5 5 2 2 0 0 8
9 2 2 2 4 4 4 6 5 5 5 5 2 2 0 0 8
7 7 7 7 7 7 7 7 7 7 7 7 7 7 7 7 7